8 14
11111111111111
00000001100001
11010101101101
10010100000111
11110111011000
10010000011011
11000110000011
11111111111111
5
2 13 2 3 3
2 13 7 9 6
6 5 7 9 2
2 3 4 10 7
7 9 5 12 4
S 2 1
E 5 14